1	1	1	1
1	0	0	1
1	0	0	1
1	P1	P0	1
1	1	1	1